1111111111111
1001000000PC1
1000011111001
110011E1C0001
1111111111111