1111111111
1001000001
1000011101
100011E0C1
1000000001
1000000001
1P00000001
1000000001
1000C00001
1111111111